1..........
......7....
......1..7.
..2........
..3..6..5.2
.....3..6..
...........
...4.......
...........
....5......
..4........