....16.......
13...........
.....4..9....
.............
..4..........
...2..7.8....
......8....a.
2..........7.
.............
...5.......9.
.....5...a...
...3.6.......
.............