..............
..............
.2.74.........
......ac......
..4...........
..5.....d.....
......a.......
.3.....db.....
.......e..e...
......5..c2...
......7.......
..3.1.9.68....
..6.89b.f...f.
1.............