..........bc.......
.1.................
.......3...........
.......7...........
...3...............
.1.4...............
....7..............
..2........9.......
...5.5...4.........
...6.6...b.........
....8..............
....9.a............
...................
...................
...........c.......
........82.....e..d
............de..a..
...................
...................