....................
.2..........d.......
.........8....c.....
...........b........
....................
........8......2....
..3...5........3....
1.............7...1.
...........c......d.
....6............e.f
..45.....9.......a..
....................
....7.......b.......
....................
....................
.........a..9e......
.............f......
......4.............
..................6.
....................