.......1.......
.2....28.9a....
...............
..3....3.......
...............
..........7....
..........b....
1..4...5..69...
......7.....b..
............c..
..45.6.........
.........8.....
...............
...........ca..
...............