....529.........
................
.2..............
......6.........
136......7......
.......a........
.4..9....b......
.......8........
1437...a........
.........b......
.5..............
...8............
................
................
................
................