.................
..236....a.......
....7......ef....
......4..........
1..........6...b.
2........a.....f.
...4...........e.
.........b.......
........9.....7..
...5.............
...........9..8..
..............c..
.................
........5........
.....8...c....d..
.......3.d.1.....
.................