1.................
..................
..................
..................
..................
..5...............
..3........8......
..................
.........9...4....
.2..2.......96....
.3......8.b...c...
.......7.....1....
.......5.a.c.7ab..
.4................
....6.............
..................
..................
..................